-19
16
-7
8
000000000000000000000000000000000000
000000000000000000000000000001111110
000000000000000000000000000001111110
000000000000000000000000000001111110
000000000000000000000000000001100110
000000000000000000000000000000000000
000000000000000000000000000000000000
000000010000000000001111111000000000
000000000000000000001111111000000000
000000000000000000001111111000000000
000000000000000000001111111010000000
000000000000000000000000000000000000
000000000000000000100000000000000000
000000000000000000000000000000000000
000000000000000000000000000000000000
000000000000000000000000000000000000
